4 4
+-------+
| |     |
| |     |
| |     |
| |  +- |
| |  |  |
| |  +  |
|    |  |
+-------+