#############
S #     #   #
# #  ##   # #
# #  ## ### #
#       #   #
######### # #
#         # E
#############